1 1 5
0 0 0 -5 0 0 -5 0 42 42
0 -11 0 0 0 0 0 0 -12 0
0 0 0 0 -9 -9 0 -3 0 0
42 42 42 0 0 0 0 42 42 42
0 -7 0 0 0 0 0 0 -6 0
-5 0 0 0 0 0 -7 0 0 -8
0 0 42 -4 0 0 42 0 0 0
0 0 0 42 0 42 0 0 0 0
0 9 0 3 42 8 0 0 9 0
0 0 0 8 3 0 5 0 0 9