1 1
-10 -11 -11 -11 -11 -11 -11 -12 -9 -9
-9 -9 -9 -9 -9 -9 -8 -8 -8 -8
-8 -7 -7 -7 -7 -6 -6 -6 -6 -5
-5 -5 -5 -4 -4 -4 -3 -3 -1 -2
0 0 0 0 0 0 0 0 0 0
0 0 0 0 0 0 0 0 0 0
9 9 9 9 9 9 8 8 8 8
8 7 7 7 7 6 6 6 6 5
5 5 5 4 4 4 3 3 1 2
10 11 11 11 11 11 11 12 9 9