1 1
-10 -11 -7 -11 -8 -9 -11 -12 -11 -9
-9 -9 -11 -8 -8 -8 -7 -11 -8 -7
-7 -9 -6 -9 -6 -9 -9 -6 -6 -5
-5 -5 -5 -4 -4 -4 -3 -3 -2 -1
0 0 42 42 0 0 42 42 0 0
0 0 42 42 0 0 42 42 0 0
1 11 9 9 9 11 10 8 9 9
3 4 5 4 5 4 8 8 3 2
11 8 9 5 9 6 6 6 9 11
7 11 5 7 7 7 6 8 11 12
