1 1 5
42 0 -7 0 0 42 5 10 10 42
42 0 0 0 0 42 9 8 3 6
0 0 0 -8 42 42 0 42 0 9
0 0 42 0 42 0 0 42 0 0
0 0 42 0 42 0 0 42 0 0
-1 42 42 0 42 -11 -5 42 0 0
0 42 -5 0 42 0 0 42 0 0
0 42 0 0 42 0 0 42 -11 -6
0 42 0 0 -9 0 0 0 0 0
-12 42 0 0 -7 0 0 0 -9 0