1 1 5
42 42 42 42 42 42 42 42 42 42 42 42 42 42 42
0 -5 0 -8 42 0 0 -1 -12 0 42 -8 0 0 0
0 0 -1 0 42 0 0 0 0 0 42 0 -1 0 0
0 -5 0 0 42 0 -3 0 -2 0 42 0 0 -5 0
42 42 0 0 42 0 0 0 0 0 42 0 0 42 42
0 0 0 0 -9 0 0 -6 0 0 -9 0 0 0 0
-7 -7 0 0 0 -9 0 0 0 -9 0 0 0 -11 -11
0 0 42 42 42 42 42 42 42 42 42 42 42 0 0
0 0 0 0 0 9 0 0 0 9 0 0 0 0 0
0 0 0 -11 0 0 9 0 9 0 0 -11 0 0 0
-4 0 0 42 0 0 0 1 0 0 0 42 0 0 -4
0 -5 0 42 0 0 2 8 3 0 0 42 0 -5 0
0 0 -6 42 0 4 5 10 6 4 0 42 -6 0 0
0 0 0 42 0 0 0 1 0 0 0 42 0 0 0
42 42 42 42 42 0 0 0 0 0 42 42 42 42 42